111  111   1111
101 1001  1    1
10010001  1    1
10 0001    1111
100001
10101
10101
 1 1
