11111111
10  0001   11111
10000001  100001    
10000001   11001
100000001111100111111
100000000000000000001
100000000000000  0001         1
1000000000000000000001       101
 1000000001110000000001     10001
  1000000000000000000001   1000001
   100  00000000000000001 100000001
    10000000000000000000010000000001
    100000000001111000000000000000001
    10000000001    100000000000000001
    1000000001      1111111000000001
    11111 111              10000001
                            100001
                             1001
                              11