NO ./path_to_the_north_texture
SO ./path_to_the_south_texture
WE ./path_to_the_west_texture
EA ./path_to_the_east_texture

F 220,100,0
C 225,30,0

11111111
10000001   11111
10000001  100001    
10000001   11001
100000001111100111111
100000000000000000001
100000000000000000001         1
1000000000000000000001       101
 1000000001110000000001     10001
  1000000000000000000001   1000001
   1000000000000000000001 100000001
    10000000000000000000010000000001
    100000000001111000000000000000001
    10000000001    100000000000000001
    1000000001      1111111000000001
    111111111              10000001
                            100001
                             1001
                              11