1111111111111111111111111111111
1000000000000000000000000000001
1000000000000000000000000000001
1000000000000000000000000000001
1000000000000000000000000000001
1000000000000000000000000000001
1000000000000000000000000000001
100000000000111111111 111111111
100000000001                   
100000000001                   
100000000001                   
100000000001                   
100000000001                   
111111111111                   
